**#**********************
**#**********************
**#**********************
**#**********************
**#**********************
**#**********************
**#**********************
**#########**************
************##***********
************##***********
************##***********
************##***********
************##***********
***************########**
**********************#**
**********************#**
**********************#**
**********************#**
**********************#**
**********************#**