*************************
*####***************####*
*#*********************#*
*#*********************#*
*#*********************#*
*************************
*************************
*************************
*************************
*************************
*************************
*************************
*************************
*************************
*************************
*#*********************#*
*#*********************#*
*#*********************#*
*####***************####*
*************************