*******#######***********
*************************
************************#
************************#
************************#
************************#
*************************
*************************
**********####***********
**********####***********
**********####***********
**********####***********
*************************
*************************
#************************
#************************
#************************
#************************
*************************
***********#######*******